18,1,13,15,18,0,6,14
15,8,20,5,1,16,15,10
2,7,11,1,13,4,19,11
12,13,9,8,14,5,9,11
4,14,7,14,19,12,1,18
0,7,4,6,9,17,11,7
10,17,14,13,15,2,20,18
10,16,5,7,13,7,1,1
